NO    ./textures/greys tone.png
SO ./textures/mossy.png
WE ./textures/redbrick.png
EA ./textures/wood.png

C 222,0,0
F 254,0,0


1111111111111111111111111111111111111111111111111111111
1000000000000000000000000000000000000000000000000000001
1000000000000000000000000000000000000000000000000000001
1000000000000000010000000000000000000000000000000000001
1000000000000000010000000000000000000000000000000000001
1000001111111111111111111111111000000000000000000000001
10000000000001                1000000000000000000000001
1000000000000111111111111111111000000000000000000000001
1000000000000100000010000000000000000000000000000000001
1000000000000100000010000000000000000000000111111111111
1111111111111111111010000000000000000000000000000000001
1000000000000100000010000000000000000000000000000000001
1000000000000101111111000011111111111111000000000000001
1000000000000101000000000000000000000000000000000000001
1000000000000101000000000000000000000000000000000000001
1000000000000101000000000000000000000000000000000001111
1000000000000101000000000000000000000000000000000001001
100000000000010100000000000000000000000000000000000DN01
1000000000000100000000000000000000000000000000000001001
1111111111111111111111111111111111111111111111111111111
