NO ./textures/greystone.png
SO ./textures/mossy.png
WE ./textures/redbrick.png
EA ./textures/wood.png

f 255,100,0
C 122,30,0


11111
100N1
10D01
10001
11111