			NO ./textures/greystone.png
SO ./textures/mossy.png
WE ./textures/redbrick.png
EA ./textures/wood.png

F 220,100,0
C 225,30,0


111111111111111111111111111111111111111111111111111111
100000000000000000000000000000000000000000000000000001
100000000000000000000000000000000000000000000000000001
100000000000000001000000000000000000000000000000000001
100000000000000001000000000000000000000000000000000001
100000111111111111111111111111100000000000000000000001
100000000000010000000000000000100000000000000000000001
100000000000010000001111111111100000000000000000000001
100000000000010000001000000000000000000000000000000001
100000000000010000001000000000000000000000000000000001
100000000000011111101000000000000000000000000000000001
100000000000010000001000000000000000000000000000000001
100000000000010111111111111111111111111100000000000001
100000000000010100000000000000000000000000000000000001
100000000000010100000000000000000000000000000000000001
100000000000010100000000000000000000000000000000000001
10000000000001010000000000000000000000000E000000000001
100000000000010100000000000000000000000000000000000001
100000000000010000000000000000000000000000000000000001
111111111111111111111111111111111111111111111111111111
