NO                     ./textures/greys tone.png
SO ./textures/mossy.png
WE ./textures/redbrick.png
EA ./textures/wood.png

F 220,100,0
C 255,30,0


111111111111111111111111111111111111111111111111111111
100000000000000000000000000000000000000000000000000001
100000000000000001111000000000000000000000000000000001
100000000000000011111100000000000000000000000000000001
10000000000000000111100000000000000000000000000000001
100000111111111111111111111111111000000000000000000001
1000000000000010000000010000000000000000000000000000001
10000000000001001001001000000000000000000000000000000001
10000000000001000000001000000000000000000000000000000001
10000000000001000000001000000000000000000000000000000001
10000000000001000000001000000000000000000000000000000011
100000000000010000000010000000000000000100000000000001
1000000000000100000011111111111111111111100000000000001
1000000000000100000011110000000000000001000000000000001
1000000000000100000011000000000000000000000000000000001
1000000000000100000010000000000000000000000000000000001
1000000000000100000010000000000000000000000000000000001
1000000000000100000011100000000000000000000000000000001
1000000000000111000000000000000000000000000000000N0001
111111111111111111111111111111111111111111111111111111
