NO ./textures/greystone.png
SO ./textures/mossy.png
WE ./textures/redbrick.png
EA ./textures/wood.png

F 255,100,0
C 122,30,0


11111
100N1
10001
10001
11111