NO ./textures/north.png
SO ./textures/south.png
WE ./textures/west.png
EA ./textures/east.png

F 257,100,0
C 225,30,0


1111111111111111111111111111111111111111111111111111111
1000000000000000000000000000000000000000000000000000001
1000000000000000000000000000000000000000000000000000001
1000000000000000010000000000000000000000000000000000001
1000000000000000010000000000000000000000000000000000001
1000001111111111111111111111111000000000000000000000001
1000000000100000000000000001000000000000000000000000001
1000000000000100000011111111111000000000000000000000001
1000000000000100000010000000000000000000000000000000001
1000000000000100000010000000000000000000000000000000001
1000000000000111111010000000000000000000000000000000001
1000000000000100000010000000000000000000000000000000001
1000000000000101111111111111111111111111000000000000001
1000000000000101000000000000000000000000000000000000001
1000000000000101000000000000000000000000000000000000001
1000000000000101000000000000000000000000000000000000001
1000000000000101000000000000000000000000000000000000001
1000000000000101000000000000000000000000000000000000001
1000000000000100000000000000000000000000000000000000001
1111111111111111111111111111111111111111111111111111111
