NO ./textures/north.png
SO ./textures/south.png
WE ./textures/west.png
EA ./textures/east.png

F 25 6,100,0
C 22    5,30,0


11111
100N1
11111
