NO ./textures/north.png
SO ./textures/south.png
WE ./textures/west.png
EA ./textures/east.png

F 256,100,0
C 225,30,0


11111
10000
11111
